0;0;0;0;0;0;0;0;0;0;0;0;0;0;0;0;0;0;0;0;0;0;0;0;0;0;0;0;0
0;0;0;0;1;1;1;18;1;1;1;0;0;0;0;0;0;0;0;0;0;0;0;0;0;0;0;0;0
0;0;0;0;1;0;0;0;0;0;1;0;0;1;1;1;1;0;0;0;0;0;0;0;0;0;0;0;0
0;0;0;0;1;0;0;0;0;0;1;0;0;1;3;1;1;0;0;0;0;0;0;0;0;0;0;0;0
0;0;0;0;1;0;0;0;0;0;1;0;0;1;0;0;1;0;0;0;0;0;0;0;0;0;0;0;0
0;2;0;0;1;0;0;0;0;0;13;0;0;9;0;0;1;0;0;0;0;0;0;0;0;0;0;0;0
0;5;0;0;1;0;0;0;0;0;1;0;0;1;0;0;1;10;1;1;0;0;0;0;1;1;0;0;0
0;1;0;0;1;0;0;0;0;0;1;0;0;1;0;0;0;0;0;1;0;0;0;0;1;0;0;0;0
0;1;0;0;1;0;0;0;0;0;1;0;0;1;0;0;0;0;0;1;0;0;0;0;1;0;0;0;0
0;7;0;0;1;0;0;0;0;0;1;0;0;1;0;0;0;0;0;1;1;1;1;1;1;0;0;0;0
0;1;1;1;1;0;0;0;0;0;1;0;0;1;0;0;0;0;0;1;0;0;0;0;1;0;0;0;0
0;1;1;0;1;0;0;0;0;0;1;0;0;1;0;0;0;0;0;1;0;0;0;0;1;0;0;0;0
0;0;0;0;13;0;0;0;0;1;1;0;0;15;0;0;0;0;0;1;0;0;0;0;1;1;0;0;0
0;0;0;0;1;0;0;0;0;0;1;0;0;1;0;0;0;0;0;1;0;0;0;0;0;1;0;0;0
0;0;0;0;1;0;0;0;0;0;1;0;0;1;0;0;0;0;0;15;0;0;0;0;0;1;0;0;0
0;0;0;0;1;0;0;0;0;0;1;0;0;1;0;0;0;0;0;1;0;0;0;0;0;1;0;0;0
0;1;1;1;1;0;0;0;0;0;1;1;1;1;0;0;0;0;0;1;0;0;0;0;0;1;0;0;0
0;0;1;0;0;0;0;0;0;0;1;0;0;0;0;0;0;0;0;1;0;0;0;0;0;1;0;0;0
0;0;1;0;0;0;0;0;1;1;1;0;0;0;0;0;0;0;0;1;0;0;0;0;0;1;0;0;0
0;0;1;0;0;0;0;0;1;0;1;0;0;0;0;0;0;0;0;1;0;0;0;0;0;1;0;0;0
0;0;1;0;0;0;0;0;1;0;1;0;0;0;0;0;0;0;0;1;0;0;0;0;1;1;0;0;0
0;0;1;1;1;18;16;1;1;0;1;0;0;0;0;0;0;0;0;1;0;0;0;0;1;0;0;0;0
0;0;1;0;0;0;0;0;0;0;15;0;0;0;0;0;0;0;0;1;0;0;0;0;1;0;0;0;0
0;0;1;0;0;0;0;0;0;0;1;0;0;0;0;0;0;0;0;1;0;0;0;0;8;0;0;0;0
0;0;1;0;0;0;0;0;0;0;1;0;0;0;0;1;1;17;1;1;0;0;0;0;1;0;0;0;0
0;0;1;0;0;0;0;0;0;0;1;0;0;0;0;1;1;0;0;1;0;0;0;0;1;1;0;0;0
0;0;1;0;0;0;0;0;0;0;1;0;0;0;0;0;1;0;0;1;0;0;0;0;1;1;0;0;0
0;0;1;0;0;0;0;0;0;0;1;0;0;0;0;0;1;0;0;1;0;0;0;0;0;1;0;0;0
0;0;1;0;0;0;0;0;0;0;1;0;0;0;0;0;1;0;0;13;0;0;0;0;0;2;0;0;0
0;0;1;0;0;0;0;0;0;0;1;0;0;0;0;0;1;0;0;1;0;0;0;0;0;1;0;0;0
0;0;1;0;0;0;0;0;0;0;1;0;0;0;0;0;1;0;0;1;0;0;0;0;0;1;0;0;0
0;0;1;0;0;0;0;0;0;0;1;0;0;0;0;0;1;16;1;1;0;0;0;0;0;1;0;0;0
0;0;1;12;1;1;1;0;0;0;1;0;0;0;0;0;1;0;0;1;1;1;1;0;0;1;0;0;0
0;0;1;0;0;0;1;1;1;1;1;0;0;0;0;0;1;0;0;0;0;0;1;0;0;1;0;0;0
0;0;15;0;0;0;0;0;0;0;0;0;4;0;0;0;1;0;0;0;0;0;1;0;0;1;0;0;0
0;0;1;0;0;0;0;0;0;0;0;0;1;0;0;0;1;0;0;0;0;0;1;0;0;1;0;0;0
0;0;1;0;0;0;0;0;0;0;0;0;1;0;0;0;1;0;0;0;0;0;1;0;0;1;0;0;0
0;0;1;0;0;0;0;0;0;0;0;0;1;0;0;0;15;0;0;0;0;0;1;0;0;1;0;0;0
0;0;1;0;0;0;0;0;0;0;0;0;1;0;0;0;1;0;0;0;0;0;1;0;0;7;0;0;0
0;0;1;0;0;0;0;0;0;0;0;0;1;0;0;0;1;0;0;0;0;0;1;1;1;1;0;0;0
0;0;1;0;0;0;0;0;0;0;0;0;1;0;0;0;1;0;0;0;0;0;0;0;0;0;0;0;0
0;0;1;1;1;1;16;1;1;1;16;1;1;1;16;1;1;0;0;0;0;0;0;0;0;0;0;0;0
0;0;0;0;0;0;0;0;0;0;0;0;0;0;0;0;0;0;0;0;0;0;0;0;0;0;0;0;0
