0;0;0;0;0;0;0;0;0;0;0;0;0;0;0;0;0;0;0;0;0;0;0
0;0;0;0;0;0;0;0;0;0;0;0;0;0;0;0;0;0;0;0;0;0;0
0;0;0;0;2;0;0;0;0;0;0;0;0;4;0;0;0;0;0;0;1;3;0
0;0;0;0;1;0;0;0;0;0;0;0;0;1;0;0;0;0;0;0;1;1;0
0;1;1;1;1;1;0;1;1;1;0;0;0;1;0;0;0;0;0;0;1;5;0
0;1;1;1;1;1;0;1;1;1;0;0;0;1;0;0;1;12;1;11;1;1;0
0;1;1;1;1;1;10;1;1;1;10;1;11;1;0;0;1;0;1;0;1;1;0
0;1;1;1;1;1;0;0;0;1;0;0;0;1;0;0;1;0;1;0;1;1;0
0;0;0;0;0;0;0;0;0;1;0;0;0;1;1;1;1;0;1;0;1;1;0
0;0;0;0;0;0;0;0;0;1;0;0;0;1;1;1;1;0;1;0;1;1;0
0;0;0;0;0;0;0;0;0;1;0;0;0;1;1;1;1;11;1;0;0;0;0
0;0;0;0;0;0;0;0;0;1;0;0;0;1;0;0;0;0;3;0;0;0;0
0;0;0;0;1;1;1;1;1;1;0;0;0;1;0;0;0;0;0;0;0;0;0
0;0;0;0;1;2;3;1;1;1;0;0;0;1;0;0;0;0;0;0;0;0;0
0;0;0;0;1;1;1;1;1;1;12;1;1;1;0;0;0;0;0;0;0;0;0
0;0;0;0;0;0;0;0;0;0;0;0;0;0;0;0;0;0;0;0;0;0;0
