0;0;0;0;0;0;0;0;0;0;0;0;0;0;0
0;0;0;0;0;0;0;0;0;0;0;0;0;0;0
0;0;0;0;0;0;0;0;0;0;0;0;0;0;0
0;0;0;0;0;0;0;0;3;1;1;1;1;1;0
0;0;4;1;0;0;0;0;0;1;0;0;5;2;0
0;0;0;1;0;0;0;0;0;1;0;0;1;4;0
0;0;0;1;0;0;0;0;0;1;0;0;0;0;0
0;0;0;8;0;0;0;0;0;9;0;0;0;0;0
0;0;1;1;1;0;0;0;3;1;1;0;0;0;0
0;0;1;1;1;0;0;0;1;1;1;0;0;0;0
0;0;1;2;1;1;10;1;1;1;1;0;0;0;0
0;0;1;1;1;0;0;0;1;1;1;0;0;0;0
0;0;0;0;0;0;0;0;1;1;1;0;0;0;0
0;0;0;0;0;0;0;0;1;1;1;0;0;0;0
0;0;0;0;0;0;0;0;0;0;0;0;0;0;0
0;0;0;0;0;0;0;0;0;0;0;0;0;0;0
0;0;0;0;0;0;0;0;0;0;0;0;0;0;0
